NO ./textures/pillar.xpm
SO ./textures/dir.xpm
WE ./textures/redbrick.xpm
EA ./textures/wood.xpm
F 220,100,0
C 225,30,0
11111111111
1000000001
1000000001
1010000001
1000001001
1000001001
1W00100001
1000001001
1000000001
1000000001
1111111111
