NO ./textures/north.xpm
SO ./textures/south.xpm
WE ./textures/west.xpm
EA ./textures/east.xpm
F 220,100,0
C 225,30,0
1111111111111111
1000010000001001
100000000N000001
1111111110111111
1001000100010001
1000010001000001
1111111111111111
