NO ./textures/north.xpm
SO ./textures/south.xpm
WE ./textures/west.xpm
EA ./textures/east.xpm
F 220,100,0
C 225,30,0
11111111111111111
10000000000000001
10000000000000001
10000000000000001
10000000000000001
10000000000100001
10000000000000001
10000000000000011
10000000000000001
10000000000000001
10000000000000001
10000000000000001
11100000000001101
100000000N0000001
