NO ./textures/stone_bricks.xpm
SO ./textures/stone_bricks.xpm
WE ./textures/bricks.xpm
EA ./textures/bricks.xpm
F 169,169,169
C 135,206,235
111111111111111111111111111111111111111
100000100000000000000000000000000000001
100000000000000000000000000000000000001
100000100000001000000000000000000000001
100000000000000000000000000000000000001
100000100000000000000000000000000000W01
100000000000001000000000000000000000001
100000100000000000000000000000000000001
100000000000000000000000000000000000001
111111111111111111111111111111111111111
